City,Population,Murder_nonnegligent_manslaughter,Rape,Robbery,Aggravated_assault,Violent_crime_total,Burglary,Larceny_theft,Motor_vehicle_theft,Arson,Property_crime_total,total_crime,crime_index,is_safe
Aberdeen,7892,0,3,7,31,41,54,229,18,0,301,342,4.33,1
Ahoskie,4772,2,1,20,33,56,68,174,11,2,253,309,6.47,0
Albemarle,16134,1,4,23,118,146,179,667,36,14,882,1028,6.37,0
Apex,56276,0,13,3,37,53,79,432,16,0,527,580,1.03,1
Asheville,93641,6,59,163,467,695,833,4552,538,20,5923,6618,7.06,0
Atlantic Beach,1506,0,3,1,5,9,43,66,5,1,114,123,8.16,0
Bailey,560,1,1,0,0,2,7,8,0,0,15,17,3.03,1
Bald Head Island,182,0,0,0,0,0,4,19,1,0,24,24,13.18,0
Banner Elk,1101,0,1,1,3,5,2,8,1,0,11,16,1.45,1
Beech Mountain,324,0,0,0,0,0,6,9,0,0,15,15,4.62,1
Belhaven,1567,0,0,0,0,0,3,16,2,1,21,21,1.34,1
Benson,3901,0,4,5,22,31,51,136,13,1,200,231,5.92,0
Bessemer City,5552,0,0,2,11,13,18,58,9,2,85,98,1.76,1
Biltmore Forest,1410,0,0,0,0,0,4,12,0,0,16,16,1.13,1
Biscoe,1724,0,0,2,4,6,9,175,2,0,186,192,11.13,0
Black Mountain,8187,0,0,3,5,8,32,137,20,2,189,197,2.40,1
Boiling Spring Lakes,6238,1,3,0,6,10,19,63,1,1,83,93,1.49,1
Boone,19893,0,6,5,15,26,34,214,13,3,261,287,1.44,1
Brevard,7928,0,6,4,8,18,23,162,3,1,188,206,2.59,1
Bunn,377,0,0,0,1,1,2,14,2,0,18,19,5.03,0
Burgaw,4176,0,5,3,5,13,17,111,2,2,130,143,3.42,1
Burlington,54108,10,42,66,342,460,534,1815,141,5,2490,2950,5.45,0
Butner,7847,0,4,4,25,33,19,91,3,0,113,146,1.86,1
Canton,4349,0,3,0,13,16,71,132,23,0,226,242,5.56,0
Cape Carteret,2076,0,0,0,4,4,3,25,2,0,30,34,1.63,1
Carolina Beach,6437,0,4,2,23,29,27,153,7,0,187,216,3.35,1
Carthage,2524,0,1,2,1,4,15,52,5,0,72,76,3.01,1
Cary,172525,1,12,34,67,114,185,1298,77,1,1560,1674,0.97,1
Chapel Hill,61457,0,10,17,31,58,184,706,36,4,926,984,1.60,1
Charlotte-Mecklenburg,944260,103,317,1975,4587,6982,5426,28304,3340,151,37070,44052,4.66,1
Cherryville,6062,0,2,1,13,16,30,117,6,0,153,169,2.78,1
Chocowinity,794,0,2,1,3,6,1,21,1,0,23,29,3.65,1
Clayton,23842,1,7,8,24,40,49,434,14,1,497,537,2.25,1
Cleveland,882,0,1,1,2,4,2,11,1,0,14,18,2.04,1
Columbus,995,0,0,0,1,1,9,33,5,1,47,48,4.82,1
Concord,96138,4,1,28,84,117,149,1338,99,8,1586,1703,1.77,1
Cooleemee,969,0,0,0,0,0,4,14,2,1,20,20,2.06,1
Creedmoor,4636,0,2,0,8,10,19,33,3,0,55,65,1.40,1
Dallas,4787,0,2,5,13,20,24,109,20,1,153,173,3.61,1
Davidson,13193,0,2,1,5,8,17,94,10,0,121,129,0.97,1
Drexel,1849,0,0,0,0,0,9,15,9,0,33,33,1.78,1
Duck,390,0,0,0,0,0,7,14,0,0,21,21,5.38,0
Dunn,9768,1,5,23,27,56,111,374,29,2,514,570,5.83,0
Durham,280282,37,121,626,1262,2046,1972,7942,758,39,10672,12718,4.53,1
East Spencer,1550,1,0,1,5,7,3,16,6,0,25,32,2.06,1
Eden,14773,4,9,9,66,88,154,339,20,3,513,601,4.06,1
Edenton,4631,2,3,5,29,39,37,99,9,0,145,184,3.97,1
Elizabeth City,17424,1,10,16,62,89,243,468,51,3,762,851,4.88,1
Elizabethtown,3447,0,2,0,15,17,47,168,10,0,225,242,7.02,0
Elon,12214,0,1,3,4,8,34,44,4,0,82,90,0.73,1
Enfield,2288,0,0,6,17,23,21,37,7,3,65,88,3.84,1
Erwin,5148,0,2,3,5,10,40,66,3,1,109,119,2.31,1
Fair Bluff,882,0,1,0,0,1,2,12,0,0,14,15,1.70,1
Fairmont,2601,0,4,2,8,14,31,88,6,1,125,139,5.34,0
Farmville,4679,0,4,4,19,27,38,140,5,0,183,210,4.48,1
Fayetteville,209614,24,117,281,1413,1835,1365,5641,385,59,7391,9226,4.40,1
Forest City,7116,1,3,8,22,34,207,357,21,1,585,619,8.69,0
Four Oaks,2224,0,0,1,6,7,1,32,2,0,35,42,1.88,1
Fuquay-Varina,30977,0,3,10,13,26,48,234,13,0,295,321,1.03,1
Garner,31137,2,7,27,43,79,110,912,54,3,1076,1155,3.70,1
Gibsonville,7356,0,5,2,10,17,84,46,6,2,136,153,2.07,1
Goldsboro,34085,2,7,50,208,267,380,1506,99,3,1985,2252,6.60,0
Granite Falls,4629,0,0,2,2,4,124,191,17,1,332,336,7.25,0
Greensboro,298025,43,113,621,1663,2440,2215,7792,987,90,10994,13434,4.50,1
Greenville,94193,5,17,94,321,437,415,2308,114,11,2837,3274,3.47,1
Havelock,20128,0,11,6,35,52,146,376,14,5,536,588,2.92,1
Haw River,2525,0,0,1,4,5,12,29,5,1,46,51,2.01,1
Henderson,14883,8,9,30,195,242,211,576,41,10,828,1070,7.18,0
Hendersonville,14234,2,9,17,33,61,124,515,41,2,680,741,5.20,0
Hertford,2109,0,1,5,7,13,25,47,3,2,75,88,4.17,1
Hickory,41040,4,16,39,106,165,235,1410,148,6,1793,1958,4.77,1
Highlands,974,0,2,0,2,4,23,43,3,1,69,73,7.49,0
High Point,113307,19,44,133,632,828,621,2705,400,18,3726,4554,4.01,1
Hillsborough,7321,0,1,11,26,38,30,350,12,0,392,430,5.87,0
Holly Ridge,2829,0,1,4,4,9,50,31,5,0,86,95,3.35,1
Holly Springs,38577,1,7,1,16,25,22,225,9,1,256,281,0.72,1
Hope Mills,15878,1,5,22,83,111,94,655,24,2,773,884,5.56,0
Hudson,3704,0,0,1,7,8,11,76,2,1,89,97,2.61,1
Huntersville,58512,1,4,23,51,79,114,769,65,0,948,1027,1.75,1
Indian Beach,119,0,0,0,0,0,2,19,0,0,21,21,17.64,0
Kannapolis,50725,1,20,36,75,132,182,872,100,2,1154,1286,2.53,1
Kenansville,855,0,1,1,0,2,3,6,0,0,9,11,1.28,1
Kernersville,24980,0,8,20,37,65,113,989,39,3,1141,1206,4.82,1
Kill Devil Hills,7268,0,5,2,12,19,55,219,7,0,281,300,4.12,1
King,6878,2,0,2,5,9,14,207,1,1,222,231,3.35,1
Kings Mountain,10965,1,3,5,6,15,67,246,30,0,343,358,3.26,1
Kitty Hawk,3563,0,2,1,1,4,17,109,1,0,127,131,3.67,1
Knightdale,18351,0,10,9,23,42,23,285,18,1,326,368,2.00,1
Laurinburg,14928,3,5,27,125,160,386,328,48,28,762,922,6.17,0
Lenoir,17904,0,17,13,48,78,234,476,89,3,799,877,4.89,1
Lexington,18917,2,1,27,91,121,149,627,36,3,812,933,4.93,1
Long View,4921,0,2,0,3,5,20,55,13,0,88,93,1.88,1
Louisburg,3549,0,2,5,16,23,30,116,3,1,149,172,4.84,1
Lowell,3709,0,2,0,7,9,5,18,13,0,36,45,1.21,1
Maggie Valley,1230,0,1,0,13,14,50,45,8,0,103,117,9.51,0
Manteo,1453,0,0,1,4,5,4,28,2,0,34,39,2.68,1
Marion,7837,0,1,1,10,12,95,301,23,0,419,431,5.49,0
Marshville,2748,0,3,3,10,16,67,58,5,0,130,146,5.31,0
Matthews,33372,3,8,18,29,58,111,959,42,0,1112,1170,3.50,1
Maysville,955,0,0,0,0,0,4,4,0,0,8,8,0.83,1
Mebane,16203,0,5,9,31,45,53,611,27,1,691,736,4.54,1
Middlesex,824,0,0,0,0,0,3,7,2,0,12,12,1.45,1
Mint Hill,27776,4,8,11,36,59,67,268,48,3,383,442,1.59,1
Mocksville,5322,0,5,4,5,14,16,90,3,4,109,123,2.31,1
Monroe,35630,2,37,70,223,332,343,1407,131,9,1881,2213,6.21,0
Mooresville,38967,1,11,9,44,65,81,913,56,8,1050,1115,2.86,1
Morehead City,9721,0,1,2,25,28,0,380,14,1,395,28,0.28,1
Morganton,16524,1,13,4,64,82,182,402,29,1,613,695,4.20,1
Morrisville,28796,0,1,2,9,12,39,324,16,2,379,391,1.35,1
Mount Olive,4652,0,1,8,19,28,27,100,5,0,132,160,3.43,1
Murfreesboro,3072,0,1,4,0,5,28,43,3,0,74,79,2.57,1
Murphy,1657,0,2,1,12,15,43,68,8,0,119,134,8.08,0
Nags Head,2963,2,2,1,13,18,23,81,3,1,107,125,4.21,1
New Bern,30187,0,5,21,99,125,195,787,17,5,999,1124,3.72,1
Newland,684,0,1,0,0,1,2,10,5,0,17,18,2.63,1
Newport,4666,0,3,0,4,7,10,38,3,0,51,58,1.24,1
Newton,13153,0,6,8,32,46,97,338,23,2,458,504,3.83,1
North Wilkesboro,4220,0,1,4,11,16,3,114,14,0,131,147,3.48,1
Oak Island,8244,0,3,1,11,15,28,99,8,0,135,150,1.81,1
Ocean Isle Beach,644,0,2,0,1,3,16,27,1,0,44,47,7.29,0
Oxford,8851,4,0,15,72,91,31,190,10,2,231,322,3.63,1
Pinehurst,16522,1,4,0,6,11,22,87,4,0,113,124,0.75,1
Pine Level,2016,0,2,1,5,8,5,19,1,1,25,33,1.63,1
Pineville,9088,1,4,21,42,68,115,956,60,3,1131,1199,13.19,0
Pittsboro,4359,0,2,2,22,26,19,61,2,1,82,108,2.47,1
Plymouth,3400,1,4,4,28,37,57,68,14,2,139,176,5.17,0
Princeton,1402,0,0,0,0,0,4,11,1,0,16,16,1.14,1
Raeford,5001,2,3,4,8,17,23,78,6,0,107,124,2.47,1
Raleigh,477828,5,164,322,731,1222,1200,6572,748,36,8520,9742,2.03,1
Red Springs,3341,1,2,6,43,52,57,128,12,3,197,249,7.45,0
Reidsville,13959,0,7,19,79,105,121,704,65,2,890,995,7.12,0
Roanoke Rapids,14354,4,8,32,84,128,166,518,22,1,706,834,5.81,0
Robersonville,1348,0,1,2,6,9,12,20,3,0,35,44,3.26,1
Rockingham,8687,1,6,13,19,39,146,269,16,3,431,470,5.41,0
Rockwell,2151,0,2,1,4,7,4,24,2,0,30,37,1.72,1
Rocky Mount,53827,16,20,103,285,424,420,1098,109,9,1627,2051,3.81,1
Rowland,1002,1,2,2,3,8,13,29,3,1,45,53,5.28,0
Roxboro,8299,1,3,12,45,61,89,269,7,3,365,426,5.13,0
Rutherfordton,4047,0,0,0,0,0,1,142,2,0,145,145,3.58,1
Salisbury,33877,2,15,69,163,249,220,1094,99,9,1413,1662,4.90,1
Selma,7018,1,3,9,42,55,36,138,30,0,204,259,3.69,1
Shallotte,4396,2,1,3,3,9,31,277,7,0,315,324,7.37,0
Siler City,8237,1,13,10,43,67,44,255,26,1,325,392,4.75,1
Smithfield,12882,2,5,15,49,71,56,387,18,1,461,532,4.12,1
Snow Hill,1513,0,1,0,4,5,24,34,0,0,58,63,4.16,1
Southern Pines,14524,1,3,11,31,46,57,295,14,2,366,412,2.83,1
Southern Shores,2940,0,1,0,0,1,7,11,1,0,19,20,0.68,1
Southport,3961,0,3,0,1,4,6,90,1,0,97,101,2.54,1
Spencer,3238,0,1,5,5,11,17,48,8,0,73,84,2.59,1
Stallings,16173,0,5,2,13,20,43,139,17,1,199,219,1.35,1
Sugar Mountain,197,0,0,0,0,0,3,5,0,0,8,8,4.06,1
Swansboro,3354,1,0,0,1,2,16,106,5,0,127,129,3.84,1
Sylva,2742,0,3,0,6,9,14,127,8,0,149,158,5.76,0
Troutman,2755,0,2,2,0,4,16,49,2,0,67,71,2.57,1
Troy,3326,0,0,3,16,19,30,63,5,0,98,117,3.51,1
Valdese,4435,0,0,0,15,15,12,44,11,0,67,82,1.84,1
Wadesboro,5228,0,6,16,77,99,77,247,12,4,336,435,8.32,0
Wake Forest,46145,1,3,4,16,24,33,344,16,0,393,417,0.90,1
Warrenton,837,0,0,1,3,4,11,28,1,0,40,44,5.25,0
Washington,9497,0,4,10,57,71,62,281,14,2,357,428,4.50,1
Waxhaw,17203,0,4,4,17,25,46,107,3,0,156,181,1.05,1
Waynesville,10146,4,3,2,53,62,143,508,34,4,685,747,7.36,0
Weaverville,4013,0,2,0,2,4,1,146,6,0,153,157,3.91,1
Wendell,8096,0,1,2,3,6,22,45,10,0,77,83,1.02,1
West Jefferson,1311,0,1,0,1,2,6,62,2,0,70,72,5.49,0
Whispering Pines,3385,0,0,0,0,0,3,28,0,0,31,31,0.91,1
Whiteville,5338,2,2,10,64,78,88,402,19,0,509,587,10.99,0
Wilkesboro,3491,0,4,2,9,15,12,204,13,2,229,244,6.98,0
Williamston,5217,1,6,3,56,66,80,260,8,2,348,414,7.93,0
Wilmington,124750,7,74,127,551,759,771,2564,258,18,3593,4352,3.48,1
Wilson,49344,2,18,60,140,220,364,1066,115,8,1545,1765,3.57,1
Windsor,3310,0,2,0,16,18,2,18,2,0,22,40,1.20,1
Winterville,9922,0,2,1,6,9,21,63,2,3,86,95,0.95,1
Wrightsville Beach,2550,0,7,2,21,30,15,77,4,1,96,126,4.94,1
Youngsville,1365,0,0,0,2,2,3,32,1,0,36,38,2.78,1
Zebulon,5814,0,1,6,17,24,24,199,11,1,234,258,4.43,1
